################
#....#?...#*....
.%...####.#.....
####.........###
.&....#####..#.!
..###..@..#..#.#
#####.....#....#
(...#######..###
#..............)
################
