################
#..............&
(...########....
#####..@.....###
....####.......*
%##....####...#.
#####)........##
#...####..######
###?........!..#
################

