################
#....#....#*....
.%...####.#.....
####.........###
.&....#####..#.!
..###..@..#..#.#
#####.....#....#
....#######..###
#..(...........)
################
